#################################################################################
#                                                                               #
#                                                                               #
#                                                                               #
#                                                                               #
#                                                                               #
#                                                                               #
#                                                                               #
#                                                                               #
#                                                                               #
#                                                                               #
#                                                                               #
#                                                                               #
#                                                                               #
#                                                                               #
#                              ###         ###############                      #
#                              ###                                              #
#                  ##                                                           #
#                ####                                              #    #       #
#               ######                                            ###  ###      #
#################################################################################
