#################################################################################
#                                                                               #
#                                                                               #
#                                                                               #
#                                                                               #
#            ###                                                                #
#                       #                                                       #
#                                                                               #
#                                                                               #
#                              #                                                #
#                                                                               #
#                                                                               #
#                                     #                                         #
#                                                                               #
#                                                                               #
#                              ---         ########===####                      #
#                                                 #   #  #                      #
#  #  ##   ###   ####   #####   ######            #   #  #                      #
#################################################################################
#                                                                               #
#################################################################################
