#################################################################################
#                                                                               #
#                                                                               #
#                                                                               #
#                                                                               #
#                                                                               #
#                                                                               #
#                                                                               #
#                                                                               #
#                                                                               #
#                                                                               #
#                                                                               #
#                                                                               #
#                                                                               #
#                                                                               #
#                              ---         ########===####                      #
#                                                 #   #  #                      #
#  #  ##   ###   ####   #####   ######            #   #  #                      #
#################################################################################
#                                                                               #
#################################################################################
