#################################################################################
#                                                                               #
#                                                                               #
#                                                                               #
#                                                                               #
#                                                                               #
#                                                                               #
#                                                                               #
#                                                                               #
#                                                                               #
#                                                                               #
#                                                                               #
#                                                                               #
#                                                                               #
#                                                                               #
#                              ---         ########===####                      #
#                                                                               #
#  #  ##   ###   ####   #####   ######                                          #
#################################################################################
#                                                                               #
#################################################################################
